air conditioner (ér condíshoner) - aire acondicionado
alarm clock (alárm clok) - reloj despertador
bed (bed) - cama
bedding (béding) - ropa de cama

bedspread (bédspred) - colcha, cubrecama
blanket (blánket) - cobija, frazada
blinds (bláinds) - persianas
bunk bed (bánk bed) - litera, cucheta

chest of drawers (chést ov dróers) - cómoda
closet (clóset) - placárd
comforter (kómforter) - cobertor acolchado
curtain (kérten) - cortina

double bed (dóbl bed) - cama matrimonial
dresser (dréser) - tocador
footboard (fútbord) - pie de la cama
hanger (hánguer) - percha

 ¡Juega gratis ahora! WordGrouper
play
headboard (hédbord) - cabecera de la cama
lamp (lámp) - lámpara
mattres (mátres) - colchón
mirror (mírr) - espejo

night table (náit téibl) - mesita de noche
phone (fóun) - teléfono
pillow (pílou) - almohada
pillowcase (pílou kéis) - funda de almohada

plug (plag) - enchufe
rug (rag) - alfombra
sheets (shíits) - sábanas
single bed (síngl bed) - cama individual

socket (sóket) - tomacorriente
switch (súich) - interruptor de luz
trunk (tránk) - baúl
wardrobe (uór-dróub) - armario, ropero