beer (bíer) - cerveza
bottle (bótl) - botella
bottle opener (bótl óupener) - destapador
bread (bréd) - pan

candle (kándl) - vela
candlestick (kándl-stik) - candelabro
chair (chéer) - silla
champagne (shampéin) - champaña

chandelier (shandelíer) - araña de techo
china (cháina) - vajilla de porcelana
coffeepot (kófi pot) - cafetera
corkscrew (kórk skrú) - sacacorchos, tirabuzón

cup (káp) - taza
dessert spoon (disért spúun) - cuchara de postre
dish (dish) - plato, comida
fork (fórk) - tenedor

play
glass (glás) - vaso
jug (dchag) - jarro
knife (náif) - cuchillo
ladle (léidl) - cucharón

mineral water (míneral uóter) - agua mineral
mug (mag) - taza grande, jarra
mustard (mústard) - mostaza
napkin (nápkin) - servilleta

oil (óil) - aceite
pepper (péper) - pimienta
pepper shaker (péper shéiker) - pimentero
pitcher (pícher) - jarra para servir

plate (pléit) - plato -recipiente-
regular water (réguiular uóter) - agua mineral sin gas
rolls (róuls) - panecillos
salad bowl (sálad bóul) - ensaladera

 ¡Juega gratis ahora! WordGrouper
play
salt (sólt) - sal
salt shaker (sólt shéiker) - salero
saucer (sóser) - platillo
silverware (sílver uér) - juego de cubiertos

sparkling water (spárklin uóter) - agua con gas
spoon (spúun) - cuchara
sugar bowl (shúgar bóul) - azucarera
table (téibl) - mesa

tablecloth (téibl-cloz) - mantel
teapot (tí pot) - tetera
teaspoon (tíi spúun) - cucharita
toothpicks (túzpiks) - mondadientes

tray (tréi) - bandeja
vinegar (vínegar) - vinagre
water (uóter) - agua
water glass (uóter glás) - copa de agua

wine (uáin) - vino
wine glass (uáin glas) - copa de vino