barbecue grill (bárbikiú gril) - parrilla para barbacoa
bucket (bákit) - cubo, balde
bush (bush) - arbusto
chain saw (chéin só) - motosierra

charcoal (chárkoul) - carbón
deck chair (dék chéar) - tumbona, reposera
fence (féns) - cerca
flower bed (fláuer bed) - arriate, parterre

flowers (fláuers) - flores
fork (fork) - horquilla
fountain (fáunten) - fuente
gate (guéit) - verja

grass (grás) - pasto
greenhouse (gríinjáus) - invernadero
grill (gríl) - parrilla
hammock (hámok) - hamaca

 ¡Juega gratis ahora! WordGrouper
play
hedge (hédch) - seto
hoe (hóu) - azadón
hose (hóus) - manguera
ladder (láder) - escalera de mano

lawn (lóon) - césped
lawnmower (lóon-móuer) - cortadora de césped
path (paz) - sendero, caminito
pond (pond) - estanque

pruning shears (prúning shíars) - tijeras podaderas
rake (réik) - rastrillo
rose bush (róus bush) - rosal
shed (shéd) - cobertizo

shovel (shávl) - pala
shrub (shráb) - arbusto
sickle (síkl) - hoz
spade (spéid) - pala

play
sprinkler (sprínkler) - regador automático
sunbed (sánbed) - tumbona, reposera
sunshade (sánsheid) - sombrilla
swimming pool (suíming púl) - piscina

trowel (tráuel) - desplantador
watering can (wótering can) - regadera
weeds (wíids) - malas hierbas
wheelbarrow (uíil bárrou) - carretilla