blender (blénder) - licuadora
bottle opener (bótl óupener) - destapador de botellas
bowl (bóul) - bol, taza grande
broom (brúm) - escoba

cake mold (kéik móuld) - molde para repostería
can opener (kán óupener) - abrelatas
canister (kánister) - bote, lata
carving knife (kárvin náif) - cuchillo para trinchar

casserole (káserol) - cazuelera
ceramic ware (serámik uéar) - vajilla de cerámica
cheese cutter (chíis káter) - cortador de queso
chopping board (chópin bóord) - tabla para cortar

cleaver (klíiver) - cuchilla para picar
coffee maker (kófi méiker) - cafetera
colander (kólander) - colador de verduras
corkscrew (kork-skrú) - destapador

play
counter (káunter) - mesada
crokery (króukeri) - loza, vajilla
cup (kap) - taza
cupboard (kábord) - alacena

cutlery (kátleri) - cubiertos
dish drainer (dish dréiner) - escurridor de platos
dish towel (dísh táuel) - repasador
dishwasher (dísh uósher) - lavaplatos

drawers (dróoers) - cajones
faucet (fóset) - canilla, grifo
food processor (fúud prosésor) - procesadora de alimentos
forks (forks) - tenedores

freezer (fríisser) - congelador
fridge (frídch) - heladera
frying pan (fráing pan) - sartén
funnel (fánl) - embudo

 ¡Juega gratis ahora! WordGrouper
play
garbage (gárbidch) - basura
gloves (glóvs) - guantes
grater (gréiter) - rallador
ice tray (áistrei) - cubetera

juicer (dchúser) - juguera
kettle (kétl) - pava
kitchen apron (kítchen éipron) - delantal de cocina
knives (náivs) - cuchillos

ladle (léidl) - cucharón
lighter (láiter) - encendedor
masher (másher) - pisapuré
microwave oven (máikroweiv óven) - horno microondas

mincer (ménser) - picador, picadora
mixer (míkser) - batidora
oven (óven) - horno
oven burner (óven bérner) - quemador del horno

play
oven mitts (óven mits) - guantes para horno
pans (pans) - ollas, caserolas y sartenes
pepper mill (péper mil) - molinillo de pimienta
pot (pot) - olla

pot holder (pot hólder) - agarradera
potato peeler (potéitou pííler) - pelapapas
pressure cooker (présher-kúker) - olla a presión
recipe (résipi) - receta

refrigerator (refridcheréitor) - heladera
roasting pan (róusting pan) - asadera
rolling pin (róulin pin) - palo de amasar
salt shaker (sólt shéiker) - salero

saucepan (sóspan) - cacerola
scouring pad (skáurin pad) - esponja limpiadora
sharpener (shárpener) - afilador de cuchillos
shelves (shélvs) - anaqueles, estantes

 ¡Juega gratis ahora! WordGrouper
play
sieve (síiv) - tamiz
sink (sínk) - pileta de lavar
soap (sóup) - jabón
spatula (spáchiula) - espátula

spoons (spúuns) - cucharas
squeezer (skuíizer) - exprimidor
steamer (stíimer) - vaporera
stove (stóuv) - cocina (aparato)

stove burners (stóuv bérners) - quemadores de cocina
strainer (stréiner) - colador chico
teapot (tíipot) - tetera
teaspoons (tíispúns) - cucharitas

toaster (tóuster) - tostadora
trash can (tráshkan) - tacho de la basura
washing-up liquid (uóshin-áp líkuid) - detergente
water heater (uóter jíiter) - calefón

whisk (wísk) - batidor de alambre
wok (wók) - sartén china