armchair (árm-cher) - sillón
ashtray (áshtréi) - cenicero
bookcase (búk-kéis) - biblioteca
carpet (kárpet) - alfombra fija

ceiling fan (síling fan) - ventilador de techo
chandelier (shandilíar) - araña
clock (klóok) - reloj de pared
coffee table (kófi-téibl) - mesita central

couch (káuch) - sofá
curtain (kérten) - cortina
cushion (kúshon) - almohadón, cojín
drapes (dréips) - cortinados

fireplace (fáier-pléis) - hogar, chimenea
firewood (fáier-wúud) - leña
furniture (férnicher) - muebles
heating (hííting) - calefacción

 ¡Juega gratis ahora! WordGrouper
play
lamp (lámp) - lámpara
light (láit) - luz
light bulb (láit bálb) - bombilla, foco
painting (péinting) - pintura, cuadro

picture (píkcher) - cuadro
plant (plánt) - planta
radiator (réidiéitor) - radiador
recliner (rikláiner) - sillón reclinador

rocking chair (róking chéer) - mecedora
rug (rág) - alfombra
sideboard (sáidbóord) - aparador
sofa (sóufa) - sofá

staircase (stér-kéis) - escalera
stereo (stériou) - estéreo
switch (suích) - interruptor
telephone (télefóun) - teléfono

television (televíshon) - televisor
vase (véis) - florero
video (vídiou) - video