bleach (blíich) - blanqueador
broom (brúm) - escoba
brush (brásh) - cepillo
bucket (bákit) - balde, cubo

clean laundry (klíin lóndri) - ropa limpia
cleanser (klénser) - producto de limpieza
clothes line (klóus láin) - tendedoro
clothes pins (clóus píns) - broches para ropa

dryer (dráier) - secadora
dustpan (dástpan) - palita recogedora
electric bulbs (iléktric bólbs) - lamparitas, focos
fabric softener (fábrik sófener) - suavizante para la ropa

feather duster (féder dáster) - plumero
garbage (gárdbidch) - basura
hanger (hánger) - percha
insecticide (inséktisáid) - insecticida

 ¡Juega gratis ahora! WordGrouper
play
iron (áiron) - plancha
ironing board (áironing bóord) - tabla de planchar
laundry (lóndri) - ropa para lavar
laundry basket (lóndri básket) - canasto de ropa

laundry detergent (lóndri ditérdchent) - detergente para la ropa
mop (mop) - fregasuelos, fregona
mousetrap (máustrap) - trampa ratonera
plunger (plándcher) - sopapa, desatascador

rag (rag) - trapo
rubber gloves (ráber glóvs) - guantes de goma
sewing machine (sóuing mashín) - máquina de coser
shelf (shélf) - estante

soap (sóup) - jabón
sponge (spándch) - esponja
stain remover (stéin rimúver) - quitamanchas
trash (trásh) - basura

play
trash bag (trásh bag) - bolsa de la basura
trash can (trásh kan) - bote de basura
vacuum cleaner (vákium klíiner) - aspiradora
washing machine (wósing mashín) - lavarropas, lavadora

wastebasket (uéist básket) - cesto de basura

