adhesive tape (adjísiv téip) - cinta adhesiva
anvil (ánvil) - yunque
awl (óul) - punzón
bolt (bóult) - bulón

brace (bréis) - taladro de mano
chain saw (chéin só) - motosierra
chisel (chísl) - cincel, formón
drill bit (dríl bit) - mecha del taladro

electric drill (iléktrik dríl) - taladro eléctrico
extension cord (exténshon kord) - cable prolongador
file (fáil) - lima
folding ruler (fóulding rúler) - metro plegable

gadget (gádchet) - aparato
glue (glúu) - pegamento
hammer (hámer) - martillo
mallet (málet) - mazo

play
masking tape (másking téip) - cinta protectora
monkey wrench (mónki rénch) - llave inglesa ajustable
nail (néil) - clavo
nail puller (néil púler) - sacaclavos

nut (nát) - tuerca
paint (péint) - pintura
paint brush (péint-brásh) - brocha
peg (peg) - clavija

plane (pléin) - cepillo
pliers (pláiers) - tenazas, pinzas
rag (rag) - trapo
rake (réik) - rastrillo

ruler (rúler) - regla
sandpaper (sándpeiper) - papel de lijar
saw (só) - serrucho
scissors (síisors) - tijeras

 ¡Juega gratis ahora! WordGrouper
play
scraper (skréiper) - raspador
screw (skrú) - tornillo
screwdriver (skrúdráiver) - destornillador
shears (shíars) - tijeras de podar

shovel (shóvel) - pala
solder (sóulder) - soldador
square (skuéer) - escuadra
tack (ták) - tachuela

tape measure (téip mésher) - cinta métrica
tool box (túul box) - caja de herramientas
tools (túuls) - herramientas
vise (váis) - torno de banco

washer (uósher) - arandela
wire (wáier) - cable
workbench (wórkbench) - mesa de trabajo
workshop (wórkshop) - taller

wrench (rénch) - llave inglesa