bay (béi) - bahía
brook (brúk) - arroyo
canyon (kánion) - cañón
channel (chánel) - canal

cliff (klíf) - acantilado
coast (kóust) - costa
creek (kríik) - riachuelo
crevice (krévis) - falla, grieta

desert (désert) - desierto
dunes (diúns) - dunas
forest (fórest) - bosque, selva
glacier (gléishier) - glaciar

gorge (górdch) - cañón, desfiladero
grove (gróuv) - bosquecillo, arboleda
gulf (gálf) - golfo
hills (hils) - sierras, colinas

play
ice floe (áis flóu) - témpano chico
iceberg (áisberg) - iceberg
island (áiland) - isla
lagoon (lagúun) - laguna

lake (leík) - lago
marsh (mársh) - pantano
meadow (médou) - prado
mountain (máuntin) - montaña

mountain range (máuntin réindch) - cordillera
narrow pass (nárrou páas) - desfiladero
oasis (ouéisis) - oasis
ocean (óushen) - océano

path (paz) - sendero, camino
peak (píik) - pico, cima
peninsula (península) - península
plain (pléin) - llanura

 ¡Juega gratis ahora! WordGrouper
play
plateau (platóu) - meseta
pond (pond) - estanque
prairie (préeri) - llanura, pradera
precipice (présipis) - precipicio

rapids (rápids) - rápidos
ravine (ravíin) - barranco
reef (ríif) - arrecife
reservoir (réservuar) - embalse

river (ríver) - río
sea (síi) - mar
shore (shóor) - orilla, costa
spring (spring) - manantial

strait (stréit) - estrecho
stream (stríím) - arroyo
summit (sámit) - cumbre
swamp (suómp) - pantano, ciénaga

play
tributary (tríbiutari) - afluente
valley (váli) - valle
volcano (volkéinou) - volcán
waterfall (wóterfól) - catarata

wood (wúud) - bosque