apple tree (ápl tríi) - manzano
ash tree (ásh tríi) - fresno
bark (báark) - corteza
beech tree (bich tríi) - haya

birch (béerch) - abedul
branch (branch) - rama
branches (bránchis) - ramas
bush (búsh) - arbusto

cactus (káctos) - cactus
cedar (sídar) - cedro
clover (klóuver) - trébol
coconut tree (koukonát tríi) - cocotero

creeper (kríiper) - enredadera
cypress (sáipres) - ciprés
elm (élm) - olmo
fir tree (fér tríi) - abeto

 ¡Juega gratis ahora! WordGrouper
play
foliage (fóulidsh) - foliage
ivy (áivi) - hiedra
leaf (líif) - hoja
leaves (líivs) - hojas

lemon tree (lémon tríi) - limonero
mahogany (mahógani) - caoba
maple (méipl) - arce
oak (óuk) - roble

olive tree (óliv tríi) - olivo
orange tree (órendch tríi) - naranjo
palm tree (pálm tríi) - palmera
pine (páin) - pino

plane tree (pléin tríi) - plátano
poplar (póplar) - álamo
roots (rúuts) - raíces
shrub (shráb) - arbusto

play
trunk (tránk) - tronco
twig (tuíg) - ramita
vine (váin) - vid, parra
vineyard (vín iard) - viñedo

walnut tree (wólnat tríi) - nogal
weeds (wíds) - malezas
weeping willow (wíiping uílou) - sauce llorón
willow (wílou) - sauce