bakery (béikeri) - panadería
barber's (bárbers) - barbería
bookstore (búkstor) - librería
butcher's (búchers) - carnicería

cake shop (kéik shop) - pastelería
candy store (kándi stor) - tienda de golosinas
children's wear (chíldrens uér) - ropa de niño
clothing store (klóuding stor) - tienda de ropas

coffee shop (kófi shop) - cafetería
confectioner's (konfékshoners) - pastelería
dairy store (déri stor) - lechería
delicatessen (délikatesen) - fiambrería

drugstore (drágstor) - farmacia
dry cleaner's (drái-klíiners) - tintorería
estate agency (estéit éidchensi) - agencia inmobiliaria
fishmonger's (físhmonguers) - pescadería

play
florist's (flórists) - floristería
fruit shop (frút shop) - frutería
furniture store (férnicher stor) - mueblería
gas station (gás stéishon) - gasolinería

greengrocer's (gríingrousers) - verdulería
grocery store (gróuseri stor) - almacén
hairdresser's (herdrésers) - peluquería
hardware shop (hárduer shop) - ferretería

herbalist's shop (hérbalists shop) - herboristería
ice-cream parlour (áiskrim párlor) - heladería
ironmonger's (áironmonguers) - ferretería
jeweller's (dchúelers) - joyería

jewellery store (dchúelri stor) - joyería
kiosk (kíosk) - quiosco
ladies' wear (léidis uér) - ropa de señora
laundromat (lóndromat) - lavandería automática

 ¡Juega gratis ahora! WordGrouper
play
leather goods shop (léder gúuds shop) - marroquinería
mall (móol) - centro comercial
market (márket) - mercado
men's wear (méns uér) - ropa de caballero

music store (miúsik stor) - tienda de música
newsstand (niússtand) - quiosco de periódicos
optician's (optíshans) - optica
perfumery (perfiúmery) - perfumería

pet shop (pét shop) - tienda de animales
pharmacy (fármasi) - farmacia
shoe shop (shú shop) - zapatería
shopping center (shóping sénter) - centro comercial

shops (shops) - tiendas
souvenir shop (suveníir shop) - tienda de souvenirs
sports store (spórts stor) - tienda de deportes
stationery store (stéishoneri stor) - papelería

play
stores (stór) - tiendas
supermarket (súpermarket) - supermercado
toy store (tói stor) - juguetería
travel agency (trável éidchensi) - agencia de viajes

vegetable store (védchetabl stor) - verdulería
video store (vídiou stor) - tienda de videos