alien (éilien) - extraterrestre
asteroid (ásteroid) - asteroide
atmosphere (átmosfíer) - atmósfera
cosmos (cósmos) - cosmos

east (íist) - este
eclipse (iklíps) - eclipse
galaxy (gálaxi) - galaxia
globe (glóub) - globo, esfera

gravity (gráviti) - gravedad
Jupiter (dchúpiter) - Júpiter
light year (láit íer) - año luz
Mars (máars) - Marte

Mercury (mérkiuri) - Mercurio
meteor (mítior) - meteoro
meteorite (mítioráit) - meteorito
morning star (mórning star) - lucero del alba

 ¡Juega gratis ahora! WordGrouper
play
Neptune (néptiun) - Neptuno
north (nórz) - norte
orbit (óorbit) - órbita
outer space (áuter spéis) - espacio exterior

planet (plánet) - planeta
Satellite (sáteláit) - satélite
Saturn (sátern) - Saturno
shooting star (shúuting stár) - estrella fugaz

solar system (sóular sístem) - sistema solar
south (sáuz) - sur
space (spéis) - espacio
star (stárs) - estrella

telescope (téleskoup) - telescopio
The Earth (érz) - La Tierra
The Milky Way (milki uéi) - La Vía Láctea
The moon (múun) - La Luna

play
The sun (san) - El Sol
UFO (iú-ef-óu) - Ovni
universe (iúni-vers) - El Universo
Uranus (iuréinos) - Urano

Venus (vínos) - Venus
west (uést) - oeste