blizzard (blísard) - tormenta de nieve
breeze (bríiss) - brisa
chilly (chíli) - frío, fresquito
clear (clíir) - despejado

cloudless (cláudles) - despejado
cloudy (cláudi) - nublado
cold (cóuld) - frío
cool (cúul) - fresco

damp (dámp) - húmedo
degrees (digríis) - grados
dew (diú) - rocío
downpour (dáunpor) - aguacero

drizzle (drísl) - llovizna
drought (dráut) - sequía
dry (drái) - seco
flood (fláad) - inundación

play
fog (fog) - niebla
foggy (fógui) - con niebla
freezing (fríising) - helado
frost (frost) - escarcha

gale (guéil) - vendaval
hail (héil) - ganizo
hailstones (héilstóuns) - piedras de granizo
hailstorm (héilstórm) - tormenta de granizo

hot (hót) - caluroso
humid (hiúmid) - húmedo
hurricane (hérrikéin) - huracán
ice (áis) - hielo

lightning (láitning) - relámpago, rayo
mild (máild) - templado
mist (mist) - neblina
overcast (óuvercást) - encapotado, cubierto

 ¡Juega gratis ahora! WordGrouper
play
rain (réin) - lluvia
rainbow (réinbou) - arco iris
raining (réining) - lloviendo
rainy (réini) - lluvioso

shower (sháuer) - aguacero
sky (skái) - cielo
sleet (slíit) - aguanieve, nevizca
snow (snóu) - nieve

snowing (snóuing) - nevando
storm (stórm) - tormenta
stormy (stórmi) - tormentoso
stuffy (stáfi) - sofocante

sunny (sáni) - soleado
thunder (zánder) - trueno
thunderstorm (zánder stórm) - tormenta eléctrica
tornado (tornéidou) - tornado

play
warm (uórm) - cálido
wet (uét) - mojado
wind (uínd) - viento
windy (uíndi) - ventoso