aunt (ant) - tía
brother (bróder) - hermano
brother-in-law (bróder in ló) - cuñado
children (children) - hijos

cousin (kósin) - primo/a
dad, daddy (dád, dádi) - papi, papito
daughter (dóter) - hija
daughter-in-law (dóter in ló) - nuera

father (fáder) - padre
father-in-law (fáder in ló) - suegro
first-born (férst-bórn) - primogénito
goddaughter (god dóter) - ahijada

godfather (god fáder) - padrino
godmother (god máder) - madrina
godson (gód son) - ahijado
grandchildren (gránd chíldren) - nietos

 ¡Juega gratis ahora! WordGrouper
play
granddaughter (gránd dóter) - nieta
grandfather (gránd fáder) - abuelo
grandmother (gránd máder) - abuela
grandparents (gránd párents) - abuelos

grandson (gránd son) - nieto
great-grandfather (gréit gránd fáder) - bisabuelo
great-grandmother (gréit gránd máder) - bisabuela
great-grandparents (gréit- gránd párents) - bisabuelos

husband (jásband) - esposo
mom, mommy (mam, mámi) - mami, mamita
mother (máder) - madre
mother-in-law (máder in ló) - suegra

nephew (néfiu) - sobrino
niece (níis) - sobrina
only child (óunli cháild) - hijo/a único/a
orphan (órfan) - huérfano

play
parents (pérents) - padres
sister (síster) - hermana
sister-in-law (síster in ló) - cuñada
son (san) - hijo

son-in-law (san in ló) - yerno
stepdaughter (stép dóter) - hijastra
stepfather (stép fáder) - padrastro
stepmother (stép máder) - madrastra

stepson (stép son) - hijastro
uncle (ankl) - tío
wife (uáif) - esposa