accountant (akáuntant) - contador
actor (áktor) - actor
actress (áctres) - actriz
announcer (anáunser) - locutor

archaeologist (arkiólodchist) - arqueólogo
architect (árkitekt) - arquitecto
artist (ártist) - artista
astrologer (astrólodcher) - astrólogo

astronaut (ástronot) - astronauta
astronomer (astrónomer) - astrónomo
athlete (azlít) - atleta
attorney (atórni) - abogado

auctioneer (okshoníer) - subastador
auditor (óditor) - auditor
author (ózor) - autor
baby-sitter (béibi-síter) - niñera

play
baker (béiker) - panadero
bank teller (bánk téler) - cajero de banco
banker (bánker) - banquero
barman (bárman) - barman, mozo

beautician (biutíshan) - esteticista
bell boy (bélbói) - botones de hotel
biologist (baiólodchist) - biólogo
blacksmith (blák smiz) - herrero

bookkeeper (búk-kíper) - perito mercantil
bricklayer (brík léier) - albañil
broker (bróuker) - agente de bolsa
builder (bílder) - constructor

bullfighter (búlfaiter) - torero
bus driver (básdráiver) - conductor de bus
businessman (bísnesman) - empresario
butcher (búcher) - carnicero

play
butler (bátler) - mayordomo
cameraman (cámera-mán) - camarógrafo
carpenter (cárpenter) - carpintero
cartoonist (cartúunist) - dibujante, caricaturista

cashier (cashíer) - cajero
chef (shef) - chef
chemist (kémist) - químico, farmacéutico
clerk (clérk) - oficinista

coach (cóuch) - entrenador
college professor (cólidch profésor) - profesor universitario
company director (cómpani diréktor) - director de empresa
composer (compóuser) - compositor

computer programmer (kompiúter prougrámer) - programador
conductor (condáktor) - director de orquesta
consultant (consóltant) - consultor
cook (cúk) - cocinero

 ¡Juega gratis ahora! WordGrouper
play
counselor (cáunselor) - asesor, consultor
cowboy (cáu bói) - vaquero
craftsman (kráfstman) - artesano
cyclist (sáiklist) - ciclista

dancer (dánser) - bailarín
decorator (dékoreitor) - decorador
dentist (déntist) - dentista
designer (disáiner) - diseñador

detective (ditéktiv) - detective
doctor (dóctor) - doctor
dog walker (dog wóker) - paseador de perros
dressmaker (drés méiker) - modista

driver (dráiver) - chofer
economist (ekónomist) - economista
electrician (iléktríshan) - electricista
employee (emploíi) - empleado

play
engineer (endchiníer) - ingeniero
farmer (fármer) - agricultor
fireman (fáier man) - bombero
fisherman (físherman) - pescador

fishmonger (fishmónguer) - vendedor de pescado
flight attendant (fláit aténdant) - azafata
florist (flórist) - florista
fortune teller (fórchun téler) - adivino

garbage collector (gárdbidch coléktor) - basurero
gardener (gárdener) - jardinero
greengrocer (gríin gróucer) - verdulero
grocer (gróuser) - almacenero

hairdresser (héar-dréser) - peluquero
historian (histórian) - historiador
house painter (háus péinter) - pintor de casas
housekeeper (háus kíiper) - ama de llaves

play
housewife (háus-uáif) - ama de casa
hunter (hánter) - cazador
instructor (instráktor) - instructor
insurance agent (inshúrans éidchent) - agente de seguros

interpreter (intérpreter) - intérprete
ironmonger (áironmonguer) - ferretero
janitor (dchánitor) - conserje
jeweller (dchúeler) - joyero

journalist (dchérnalist) - periodista
judge (dchádch) - juez
lawyer (lóier) - abogado
lifeguard (láif-gard) - bañero

locksmith (lóksmiz) - cerrajero
magician (madchíshan) - mago
maid (méid) - empleada doméstica
mailman (méilman) - cartero

 ¡Juega gratis ahora! WordGrouper
play
manager (mánidcher) - gerente
manicurist (manikiúrist) - manicuro
manufacturer (maniufákcherer) - fabricante, industrial
masseur (maséer) - masajista hombre

masseuse (masées) - masajista mujer
mathematician (mazematíshan) - matemático
mechanic (mekánik) - mecánico
milkman (mílkman) - lechero

miner (máiner) - minero
model (módel) - modelo
musician (miusíshan) - músico
newspaper boy (nuspéiper bói) - repartidor de diarios

nun (nan) - monja
nurse (néers) - enfermero/a
ophthalmologist (oftalmólodchist) - oftalmólogo
optician (optíshan) - óptico

play
orator (órator) - orador
paediatrician (pediatríshan) - pediatra
painter (péinter) - pintor
park ranger (park réindcher) - guardaparques

peasant (pésant) - campesino
pharmacist (fármasist) - farmacéutico
philosopher (filósofer) - filósofo
photographer (fotóugrafer) - fotógrafo

physician (fisíshan) - médico
physicist (físisist) - físico
pianist (píanist) - pianista
pilot (páilot) - piloto

plumber (plámer) - plomero, fontanero
poet (póuet) - poet
police officer (polís ófiser) - agente de policía
policeman (polísman) - policía

play
politician (politíshan) - político
postman (póustman) - cartero
presenter (prisénter) - presentador
president (président) - presidente

priest (príist) - sacerdote
printer (prínter) - imprentero
programmer (prougrámer) - programador
psychiatrist (saikáiatrist) - psiquiatra

psychologist (saikólodchist) - psicólogo
psychoterapist (saikotérapist) - psicoterapeuta
publisher (páblisher) - editor
receptionist (risépshonist) - recepcionista

reporter (ripórter) - reportero
researcher (risércher) - investigador
sailor (séilor) - marinero
salesclerk (seilsclérk) - vendedor

 ¡Juega gratis ahora! WordGrouper
play
salesman (séilsman) - vendedor
saleswoman (séilswúman) - vendedora
scientist (sáientist) - científico
sculptor (skálpter) - escultor

seamstress (símstres) - costurera
secret agent (síkret éidchent) - agente secreto
secretary (sécretéri) - secretario/a
security guard (sekiúriti gárd) - guardia de seguridad

servant (sérvant) - criado
shepherd (shépard) - pastor
shoemaker (shúméiker) - zapatero
shopkeeper (shóp kíiper) - comerciante, tendero

singer (sínguer) - cantante
soccer player (sóker pléier) - futbolista
social worker (sóushal uérker) - trabajadora social
soldier (sóuldcher) - soldado

play
sportsman (spórts-mán) - deportista
state agent (stéit éidchent) - agente inmobiliario
stationer (stéishoner) - librero
statistician (statistíshan) - estadístico

stenographer (stenógrafer) - taquígrafo
stewardess (stúardes) - azafata
stockbrocker (stók-bróuker) - corredor de bolsa
street sweeper (stríit suíper) - barrendero

student (stiúdent) - estudiante
supervisor (súpervaisor) - supervisor
surgeon (sérdchon) - cirujano
tailor (téilor) - sastre

tax inspector (táks inspéktor) - inspector de impuestos
taxi driver (táksi dráiver) - taxista
taylor (téilor) - sastre
teacher (tícher) - maestro

play
technician (tekníshan) - técnico
telephone operator (télefoun operéitor) - telefonista
tourist guide (túrist gáid) - guía de turistas
translator (transléitor) - traductor

travel agent (trável éídchent) - agente de viajes
truck driver (trók dráiver) - camionero
typist (táipist) - mecanógrafa
undertaker (ander téiker) - funebrero

veterinarian (veterinérian) - veterinario
waiter (wéiter) - camarero
waitress (wéitres) - camarera
watchmaker (wóchméiker) - relojero

welder (wélder) - soldador
worker (wérker) - obrero
writer (ráiter) - escritor