afraid (afréid) - temeroso, con miedo
alarmed (alármd) - alarmado
alert (alért) - alerta
amazed (améist) - asombrado

angry (ángri) - enojado
annoyed (anóid) - molesto
ashamed (ashéimd) - avergonzado
astonished (astónisht) - asombrado

bored (bóord) - aburrido
calm (káam) - calm
cheerful (chíirful) - alegre
complacent (kompléisent) - satisfecho consigo mismo

confident (cónfident) - confiado
confused (confiúst) - confundido
content (contént) - satisfecho
content (contént) - contento

play
contented (conténtid) - contento, satisfecho
curious (kiúrios) - curioso
dejected (didchéctid) - desanimado
delighted (diláitid) - encantado

depressed (diprést) - deprimido
disappointed (disapóintid) - defraudado
disheartened (disjártend) - descorazonado
disillusioned (disilúshond) - desilusionado

distressed (distrést) - angustiado
dizzy (díssi) - mareado
drunk (dránk) - borracho
eager (íguer) - ansioso, deseoso

edgy (édchi) - nervioso, inquieto
elated (iléitid) - regocijado
embarrassed (embárrast) - avergonzado, abochornado
emotional (imóushonal) - emocionado, sensible

 ¡Juega gratis ahora! WordGrouper
play
enthusiastic (enzusiástic) - entusiasmado
envious (énvias) - envidioso
excited (exáitid) - excitado
frustrated (frostréitid) - frustrado

furious (fiúrios) - furioso
glad (glad) - contento
gloomy (glúmi) - triste, pesimista
grateful (gréitful) - agradecido

groggy (grógui) - aturdido
grumpy (grámpi) - malhumorado
guilty (guílti) - culpable
happy (hápi) - feliz, contento

homesick (hóumsik) - nostálgico
hopeful (hóupful) - esperanzado
horny (hórni) - caliente, cachondo
hostile (hóstil) - hostil

play
humiliated (hiumílieitid) - humillado
hungry (hángri) - hambriento, con hambre
hurt (héert) - herido
impressed (imprést) - impresionado

in love (in lóv) - enamorado
indifferent (indíferent) - indiferente
indignant (indígnant) - indignado
insecure (ínsekiúr) - inseguro

irritable (írritabl) - irritable
jealous (dchélos) - celoso
jubilant (dchúbilant) - jubiloso
lazy (léisi) - perezoso

listless (lístles) - indiferente, desganado
lonely (lóunli) - solitario, solo
merry (mérri) - alegre
mischievous (míschivas) - travieso

 ¡Juega gratis ahora! WordGrouper
play
miserable (míserabl) - triste, desgraciado
nervous (nérvos) - nervioso
nostalgic (nostáldchik) - nostálgico
offended (ofénded) - ofendido

optimistic (óptimístic) - optimista
overwhelmed (óuver-uélmd) - agobiado
playful (pléiful) - juguetón
pleased (plíist) - complacido, satisfecho

positive (pósitiv) - positivo
proud (práud) - orgulloso
puzzled (pásld) - confundido
rejected (ridchékted) - rechazado

relaxed (riláxt) - relajado
relieved (rilíivt) - aliviado
resentful (riséntful) - resentido
restless (réstles) - inquieto

play
sad (sad) - triste
satisfied (sátisfaid) - satisfecho
scared (skéerd) - asustado
sentimental (sentiméntal) - sentimental

shocked (shókt) - impresionado, conmovido
sick (sik) - enfermo
sleepy (slíipi) - soñoliento
surprised (sorpráist) - sorprendido

terrified (térrifaid) - aterrorizado
thankful (zánkful) - agradecido
thirsty (zérsti) - sediento, con sed
thoughtful (zótful) - pensativo

thrilled (zríld) - estremecido
tired (táierd) - cansado, fatigado
touched (tácht) - emocionado
touchy (táchi) - susceptible

play
uncomfortable (ankómfortabl) - incómodo, molesto
unhappy (anhápi) - desdichado
upset (apsét) - molesto
wary (wéri) - cauteloso

weary (wíiri) - cansado
worried (wórrid) - preocupado