anorak (ánorak) - campera de esquiar
belt (belt) - cinturón
boots (búts) - botas
bow-tie (bóu tái) - moño

briefs (brífs) - calzoncillos
cap (kap) - gorra
cardigan (kárdigan) - pulóver abierto
coat (kóut) - abrigo

collar (kólar) - cuello de camisa
cuff (kaf) - puño de camisa
denim jacket (dénim dcháket) - campera de jean
gloves (glóvs) - guantes

handkerchief (hándkerchif) - pañuelo de bolsillo
hat (hat) - sombrero
jacket (dcháket) - saco sport, chaqueta
jeans (dchíins) - pantalón vaquero

play
leather jacket (léder dcháket) - campera de cuero
neckerchief (nékerchif) - pañuelo de cuello
overalls (ouveróls) - mameluco, overol
overcoat (óuverkóut) - abrigo, sobretodo

pajamas (padchámas) - piyama
pants (pants) - pantalones
pullover (pulóuver) - pulóver
raincoat (réinkóut) - impermeable

scarf (skárf) - bufanda
shirt (shert) - camisa
shoes (shus) - zapatos
shorts (shorts) - pantalón corto

slacks (sláks) - pantalones informales
slippers (slípers) - pantuflas
sneakers (sníkers) - zapatillas
socks (sóks) - calcetines, medias

 ¡Juega gratis ahora! WordGrouper
play
sportswear (spórts-uéar) - ropa deportiva
suit (siút) - traje de vestir
suspenders (saspénders) - tiradores
sweater (suéter) - pulóver

sweatshirt (suét shért) - sudadera, buzo
swimming trunks (suímin tránks) - traje de baño, malla
T-shirt (ti shért) - camiseta, remera
tennis shoes (ténis shús) - zapatillas deportivas

tie (tái) - corbata
trousers (tráusserss) - pantalones
tuxedo (taksídou) - esmoquin
umbrella (ambréla) - paraguas

underpants (ánderpants) - calzoncillos
undershirt (ándershert) - camiseta
underwear (ánder wér) - ropa interior
vest (vést) - chaleco

wallet (wólet) - billetera