bag (bag) - bolso
bathrobe (báz róub) - bata de baño
belt (belt) - cinturón
beret (beréi) - boina

bikini (bikíni) - bikini
blouse (bláus) - blusa
boots (búuts) - botas
bra (brá) - corpiño, sostén

bracelet (bréislet) - pulcera, brazalete
cloak (klóuk) - capa
coat (kóut) - abrigo
corset (kórsit) - faja, corsé

dress (dres) - vestido
earring (írring) - aro, pendiente
fan (fan) - abanico
flip-flops (flípflóps) - ojotas, chancletas

play
fur coat (féer kóut) - saco de piel
garter belt (gárter belt) - liguero
gloves (glóvs) - guantes
handkerchief (hánkerchif) - pañuelo de bolsillo

jeans (dchíins) - pantalones vaqueros
knickers (níkers) - bragas, bombacha
lapel (lapél) - solapa
leggings (léguins) - calzas deportivas

miniskirt (míniskért) - minifalda
neckerchief (nékerchif) - pañuelo de cuello
necklace (nékles) - collar
nightgown (náit góun) - camisón

pajamas (padchámas) - piyama
panties (pántis) - bragas, bombacha
pullover (pulóuver) - pullover
purse (péers) - cartera

 ¡Juega gratis ahora! WordGrouper
play
raincoat (réinkout) - impermeable, gabardina
sandals (sándals) - sandalias
scarf (skarf) - bufanda
shawl (shól) - chal

shoes (shúus) - zapatos
shorts (shorts) - pantalón corto
skirt (skért) - falda
slip (slip) - combinación, enagua

slippers (slípers) - pantuflas
socks (soks) - calcetines, medias
stockings (stókins) - medias
sunglasses (sán glásis) - gafas de sol

sweater (suéter) - suéter
tennis shoes (ténis shus) - zapatillas
tights (táits) - medias bombacha
trousers (tráusers) - pantalón

umbrella (ambréla) - paraguas
vest (vést) - chaleco