adventurous (advénchuros) - aventurero
ambitious (ambíshos) - ambicioso
amusing (amiúsing) - divertido
attentive (aténtiv) - atento, cortés

audacious (odéishos) - audaz
brave (bréiv) - valiente
broad-minded (bróod-máindid) - liberal, tolerante
calm (káam) - calmo

carefree (kéerfri) - despreocupado
careful (kéerful) - prudente
cautious (kóshos) - cauteloso, prudente
charming (chárming) - encantador

cheerful (chíirful) - alegre
considerate (consíderet) - considerado
courageous (caréidchos) - valeroso, valiente
creative (criéitiv) - creativo

play
curious (kiúrios) - curioso
dependable (dipéndabl) - fiable, confiable
determined (ditérmind) - decidido, resuelto
discreet (diskríit) - discreto

easy-going (ísi-góuing) - relajado, tranquilo
energetic (enerdchétic) - energético
enthusiastic (enzúsiástic) - entusiasta
extrovert (ékstrovért) - extrovertido

faithful (féizful) - fiel
frank (fránk) - franco
friendly (fréndli) - amigable
generous (dchéneros) - generoso

gentle (dchéntl) - suave, tierno
grateful (gréitful) - agradecido
hard-working (hárd wérkin) - trabajador
honest (ónest) - honesto

 ¡Juega gratis ahora! WordGrouper
play
humble (hámbl) - humilde
imaginative (imádchinativ) - imaginativo
ingenious (indchínios) - ingenioso
intelligent (intélidchént) - inteligente

kind (káind) - amable
light-hearted (láit-jártid) - alegre
likable (láikabl) - agradable, simpático
lively (láivli) - vivaz

loyal (lóial) - leal
mature (machúur) - maduro
methodical (mezódical) - metódico
meticulous (metíkiulos) - meticuloso

modest (módest) - modesto
obedient (obídient) - obediente
optimistic (optimístik) - optimista
organized (órganaist) - organizado

play
outgoing (áutgóuin) - sociable, extrovertido
passionate (páshonet) - apasionado
patient (péishent) - paciente
polite (poláit) - cortés, atento

practical (práktikal) - práctico
quiet (kuáiet) - callado, reservado
realistic (rialístic) - realista
reliable (riláiabl) - confiable

resourceful (risóorsful) - habilidoso, ingenioso
respectful (rispéktful) - respetuoso
responsible (rispónsibl) - responsable
self-confident (sélf-kónfident) - seguro

sensible (sénsibl) - sensato
sensitive (sénsitiv) - sensible
serious (sírios) - serio, formal
sincere (sinsíer) - sincero

play
smart (smárt) - listo, inteligente
sociable (sóushabl) - sociable
strong-willed (stróng-uíld) - tenaz
sympathetic (simpazétic) - compasivo, comprensivo

systematic (sistemátik) - sistemático
talkative (tókativ) - hablador
thankful (zánkful) - agradecido
thrifty (zrífti) - ahorrativo

tolerant (tólerant) - tolerante
trustworthy (trást-wordi) - confiable
truthful (trúuzful) - veraz, sincero
understanding (anderstánding) - comprensivo

wise (wáis) - sabio
zealous (ssélos) - entusiasta, ferviente