absent-minded (ábsent-máindid) - distraído
aggressive (agrésiv) - agresivo
annoying (anóing) - molesto
arrogant (árrogant) - arrogante, prepotente

arrogant (árrogant) - arrogante
bad-tempered (bád témperd) - malhumorado
boastful (bóustful) - fanfarrón
boring (bóring) - aburrido

bossy (bósi) - mandón
cheeky (chíiki) - atrevido
clumsy (clamsi) - torpe
competitive (compétitiv) - competitivo

conceited (consítid) - vanidoso
cowardly (káuarly) - cobarde
credulous (crédchulos) - crédulo
cruel (crúel) - cruel

play
dishonest (disónest) - deshonesto
disrespectful (disrispéktful) - irrespetuoso
dominant (dóminant) - dominante
eccentric (ikséntrik) - excéntrico

envious (énvios) - envidioso
fiend (fíind) - desalmado
forgetful (forguétful) - olvidadizo
frivolous (frívolos) - frívolo

fussy (fási) - quisquilloso, exigente
gullible (gálible) - crédulo
hypocritical (jipocrítikal) - hipócrita
impatient (impéishent) - impaciente

impulsive (impólsiv) - impulsivo
indifferent (indíferent) - indiferente
insecure (ínsekiúr) - inseguro
insensitive (insénsitiv) - insensible

 ¡Juega gratis ahora! WordGrouper
play
insolent (ínsolent) - insolente
introverted (íntrovérted) - introvertido
irascible (irásibl) - irascible
irresponsible (irrispónsibl) - irresponsable

jealous (dchélos) - celoso
lazy (léissi) - haragán
lonely (lóunli) - solitario
materialistic (matirialístic) - materialista

mean (míin) - mezquino, malo
moody (múudi) - malhumorado
naive (naíiv) - ingenuo
nosy (nóusi) - metido, fisgón

obsessive (obsésiv) - obsesivo
obstinate (óbstinet) - obstinado, testarudo
passive (pásiv) - pasivo
pessimistic (pesismístic) - pesimista

play
petty (péti) - mezquino
pretentious (priténshos) - presuntuoso, pretencioso
proud (práud) - orgulloso
rash (rásh) - imprudente, precipitado

rebellious (ribélios) - rebelde
restless (réstles) - inquieto
rude (rúud) - descortés, grosero
ruthless (rúzles) - despiadado

selfish (sélfish) - egoísta
shy (shái) - tímido
spiteful (spáitful) - rencoroso
stingy (stíndchi) - tacaño

strict (stríkt) - estricto
stubborn (stáborn) - terco
sullen (sólen) - hosco
talkative (tókativ) - charlatán

play
unpredictable (anpredíktabl) - impredecible
unreliable (anreláiabl) - desconfiable
vain (véin) - presumido
vicious (víshos) - despiadado, cruel

vindictive (vindíktiv) - vengativo