acne (ákni) - acné
Aids (éidss) - sida
allergy (álerdchi) - alergia
anemia (anímia) - anemia

appendicitis (apendisáitis) - apendicitis
asthma (ázma) - asma
backache (bák-éik) - dolor de espalda
bleeding (blíiding) - pérdida de sangre

blister (blíster) - ampolla
broken leg (bróuken leg) - pierna rota
bruise (brúus) - moretón
bump (bamp) - chichón

burn (bérn) - quemadura
cancer (cáncer) - cáncer
chickenpox (chíkenpox) - varicela
cold (kóuld) - resfrío

play
concussion (konkáshon) - conmoción cerebral
constipation (konstipéishn) - estreñimiento
corn (kórn) - callo
cough (kóf) - tos

cut (cat) - corte
depression (dipréshon) - depresión
diarrhea (dairría) - diarrea
disease (disííss) - enfermedad

dry skin (drái skín) - piel reseca
earache (íar-éik) - dolor de oído
epidemic (epidémik) - epidemia
fever (fíver) - fiebre

fracture (frákcher) - fractura
headache (héd-éik) - dolor de cabeza
heart attack (hárt aták) - ataque cardíaco
hemorrhage (hémo-ridch) - hemorragia

 ¡Juega gratis ahora! WordGrouper
play
hiccups (híkaps) - hipo
illness (ílnes) - enfermedad
infection (infékshon) - infección, contagio
inflammation (inflaméishon) - inflamación

injury (índchuri) - herida
insect bite (ínsekt báit) - picadura de insecto
insomnia (insómnia) - insomnio
itch (ítch) - picazón

jaundice (dchóndis) - ictericia
leprosy (léprosi) - lepra
leukemia (lukímina) - leucemia
measles (mísls) - sarampión

miscarriage (miskérridch) - aborto espontáneo
mumps (mámps) - paperas
rabies (réibiiss) - rabia
rash (rásh) - sarpullido

play
scar (skár) - cicatriz
scratch (skrach) - rasguño
smallpox (smólpox) - viruela
sore throat (sór zróut) - garganta inflamada

sprain (spréin) - torcedura
stomachache (stómak-éik) - dolor de estómago
stress (strés) - estrés
stroke (stróuk) - ataque, apoplejía

sunburn (sán-bérn) - quemadura de sol
sunstroke (sánstróuk) - insolación
swelling (suéling) - hinchazón
the flu (de flú) - gripe

toothache (túz-éik) - dolor de dientes
ulcer (ólcer) - úlcera
vomit (vómit) - vómito
wound (wúund) - herida