Afghanistan (afgánistan) - Afganistán
Argentina (ardchentína) - Argentina
Australia (ostréilia) - Australia
Austria (óstria) - Austria

Belgium (bélchom) - Bélgica
Bolivia (bolíivia) - Bolivia
Brazil (brasíl) - Brasil
Bulgaria (balguéria) - Bulgaria

Canada (kánada) - Canadá
Chile (chíli) - Chile
China (cháina) - China
Colombia (kolómbia) - Colombia

Costa Rica (kostaríka) - Costa Rica
Cuba (kiúba) - Cuba
Czech Republic (chék ripóblik) - República Checa
Denmark (dénmark) - Dinamarca

play
Dominican Republic (domínikan ripáblik) - República dominicana
Ecuador (ékuador) - Ecuador
Egypt (ídchipt) - Egipto
Englan (íngland) - Englan

Finland (fínland) - Finlandia
France (fráns) - Francia
Germany (dchérmani) - Alemania
Greece (gríis) - Grecia

Greenland (gríinland) - Groenlandia
Guatemala (guatemála) - Guatemala
Haiti (héiti) - Haití
Hawaii (hauái) - Hawai

Honduras (hondúras) - Honduras
Hungary (hángari) - Hungría
Iceland (áisland) - Islandia
India (índia) - India

 ¡Juega gratis ahora! WordGrouper
play
Indonesia (indounísha) - Indonesia
Iran (irán) - Irán
Iraq (irák) - Iraq
Ireland (áirland) - Irlanda

Israel (ísrael) - Israel
Italy (ítali) - Italia
Jamaica (dchaméika) - Jamaica
Japan (dchapán) - Japón

Korea (koría) - Corea
Lebanon (lébanon) - Líbano
Malaysia (maléisha) - Malasia
Malta (mólta) - Malta

Mexico (méksikou) - México
Morocco (morókou) - Marruecos
Nepal (nepál) - Nepal
Netherlands (néderlands) - Países Bajos

play
New Zealand (niú síiland) - Nueva Zelanda
Nicaragua (nikarágua) - Nicaragua
Nigeria (naidchíiria) - Nigeria
Norway (nóorwei) - Noruega

Pakistan (pákistan) - Paquistán
Palestine (pálestain) - Palestina
Panama (pánama) - Panamá
Paraguay (páraguai) - Paraguay

Peru (perú) - Perú
Philipines (filipíns) - Philipines
Poland (póuland) - Polonia
Portugal (pórchugal) - Portugal

Puerto Rico (puértou ríkou) - Puerto Rico
Rumania (ruméinia) - Rumania
Russia (rásha) - Rusia
Saudi Arabia (sáudi oréibia) - Arabia Saudí

 ¡Juega gratis ahora! WordGrouper
play
Scotland (skótland) - Escocia
Singapore (síngapur) - Singapur
Spain (spéin) - España
Sweden (suíiden) - Suecia

Switzerland (suítserland) - Suiza
Syria (síria) - Siria
Tahiti (tahíti) - Tahití
Thailand (táiland) - Tailandia

Tunisia (tunísha) - Túnez
Turkey (térki) - Turquía
Ukraine (iukréin) - Ucrania
United Kingdom (iunáited kíngdom) - Reino Unido

United States (iunáited stéits) - Estados Unidos
Uruguay (iúruguai) - Uruguay
Venezuela (vénessuela) - Venezuela
Vietnam (vietnám) - Vietnam

Wales (wéils) - País de Gales
Yugoslavia (dchúgoslávia) - Yugoslavia