accesory (aksésori) - cómplice
acquittal (akuítal) - absolución
alibi (álibai) - coartada
appeal (apíil) - apelación

arson (árson) - incendio premeditado
arsonist (ársonist) - incendiario
assailant (aséilant) - agresor
assassin (asásin) - asesino (de un político)

assassination (asasinéishon) - asesinato (de un político)
assault (asólt) - agresión
attorney (atórni) - abogado
bail (béil) - fianza

blackmail (blákmeil) - chantaje
blackmailer (blákmeiler) - chantajista
briber (bráiber) - sobornador
bribery (bráiberi) - soborno

play
burglar (bérglar) - ladrón (de casas)
burglary (bérglari) - hurto (de casas)
convict (kónvict) - presidiario
court (kórt) - corte

court case (kórt kéis) - pleito
court order (kórt órder) - orden judicial
crime (kráim) - delito
custody (kástodi) - custodia

death penalty (déz pénalti) - pena de muerte
defendant (deféndant) - acusado
drug dealer (drág díiler) - vendedor de drogas
evidence (évidens) - evidencia

felony (féloni) - crimen
fine (fáin) - multa
forger (fórdcher) - falsificador
forgery (fordchery) - falsificación

play
fraud (fróod) - fraude
guilty (guílti) - culpable, inocente
heir (éer) - heredero
hijacking (jái dchákin) - secuestro de avión

hostage (jóstidch) - rehén
indictment (indáitment) - acusación
innocent (ínosent) - inocente
jail (dchéil) - cárcel

judge (dchádch) - juez
jury (dchúri) - jurado
kidnapper (kidnáper) - secuestrador
kidnapping (kidnápin) - secuestro

lawyer (lóier) - abogado
life sentence (láif séntens) - cadena perpetua
misdemeanor (misdimínor) - delito menor
mugger (máguer) - atracador

 ¡Juega gratis ahora! WordGrouper
play
mugging (máguing) - atraco
murder (mérder) - asesinato
murderer (mérderer) - asesino
narco-trafficker (narcotráfiker) - narcotraficante

narco-trafficking (narcotráfikin) - narcotráfico
not guilty (not guílti) - no culpable
oath (óuz) - juramento
on parole (on paróul) - en libertad condicional

on probation (on probéishon) - en libertad condicional
pickpocket (pikpókit) - carterista
pimp (pimp) - proxeneta
prison (príson) - prisión

proof (prúuf) - prueba
prostitute (próstitiut) - prostituta
prostitution (prostitúshon) - prostitución
punishment (pánishment) - castigo

play
ransom (ránsom) - dinero de rescate
rape (réip) - violación sexual
rapist (réipist) - violador
robber (róber) - ladrón

robbery (róberi) - hurto
shoplifter (shop-lífter) - ladrón de tiendas
shoplifting (shop-lífting) - hurto en tiendas
smuggler (smágler) - contrabandista

smuggling (smágling) - contrabando
statement (stéitment) - declaración
Supreme Court (suprím kórt) - Suprema Corte
suspect (sáspekt) - sospechoso

swindle (suíndl) - estafa
swindler (suíndler) - estafador
terrorism (térrorism) - terrorismo
terrorist (térrorist) - terrorista

play
testimony (téstimoni) - testimonio
theft (zeft) - robo
thief (zíiif) - ladrón
threat (zrét) - amenaza

to abduct (tu abdákt) - raptar, secuestrar
to accuse (tu akiúus) - acusar
to acquit (tu akuít) - absolver
to arrest (tu arrést) - arrestar

to assassinate (tu asásineit) - asesinar (a un político)
to assault (asólt) - agredir
to be tried (tu bi tráid) - ser juzgado
to beat up (tu bíit ap) - dar una paliza

to blackmail (tu blákmeil) - chantajear
to bribe (tu bráib) - sobornar
to burgle (tu bérgl) - hurtar
to convict (tu konvíkt) - declarar culpable

 ¡Juega gratis ahora! WordGrouper
play
to defend (tu difénd) - defender
to drug (tu drag) - drogar
to fine (tu fáin) - multar
to forge (tu fórdch) - falsificar

to imprison (to impríson) - encarcelar
to interrogate (tu intérroguéit) - interrogar
to kidnap (tu kídnap) - secuestrar
to kill (tu kil) - matar

to lock up (tu lók áp) - encerrar
to mug (tu mág) - atracar
to murder (tu mérder) - asesinar
to plead guilty (tu plíid guílti) - confesarse culpable

to poison (tu póisn) - envenenar
to prosecute (tu prósekiut) - procesar, enjuiciar
to rape (tu réip) - violar
to release (tu rilíis) - poner en libertad

play
to rob (tu rob) - robar
to search (tu sérch) - registrar
to sentence (tu séntens) - sentenciar
to serve a sentence (tu sérv a séntens) - cumplir una condena

to set fire (tu set fáier) - incendiar
to shoot (tu shúut) - disparar
to shoplift (tu shop-líft) - hurtar en tiendas
to smuggle (tu smágl) - contrabandear

to spy (tu spái) - espiar
to stab (tu stáb) - apuñalar
to steal (tu stíil) - robar
to strangle (tu strángl) - estrangular

to surround (tu sorráund) - rodear
to swindle (tu suíndl) - estafar
to threaten (tu zréten) - amenazar
to vandalize (tu vándalais) - destrozar propiedad

play
to violate (tu váioleit) - violar
trial (tráial) - juicio
vandal (vándal) - vándalo
vandalism (vándalism) - vandalismo

verdict (vérdikt) - veredicto
violation (vaioléishon) - violación
violator (vaioléitor) - violador
witness (uítnes) - testigo