air force (éer fórs) - fuerza aérea
allied forces (álaid fórsis) - fuerzas aliadas
armed forces (ármd fórsis) - fuerzas armadas
army (ármi) - ejército

artillery (artíleri) - artillería
attack (aták) - ataque
battery (báteri) - batería
battle (bátl) - batalla

bomb (bóm) - bomba
camouflage (kámofladsh) - camuflaje
captain (kápten) - capitán
casualties (káshualtis) - bajas de guerra

ceasefire (síisfáier) - alto el fuego
civilians (sivílians) - civiles
colonel (kérnel) - coronel
combat (kómbat) - combate

play
commander (kománder) - comandante
conflict (kónflikt) - conflicto
enemy (énemi) - enemigo
explosion (eksplóushon) - explosión

general (dchéneral) - general
grenade (grenéid) - granada
helicopter (hélicopter) - helicóptero
hostilities (hostílitis) - hostilidades

human rights (hiúman ráits) - derechos humanos
humanitarian aid (hiumanitérian éid) - ayuda humanitaria
injured (índcherd) - herido
invasion (invéishon) - invasión

lieutenant (luténant) - teniente
military (mílitari) - militar
military base (mílitari béis) - base militar
military intelligence (mílitari intélidchens) - inteligencia militar

 ¡Juega gratis ahora! WordGrouper
play
mine (máin) - mina
minefield (máinfild) - campo minado
missile (mísel) - misil
navy (néivi) - marina

patrol (patróul) - patrulla
peace (píis) - paz
pilot (páilot) - piloto
prisoner (prísoner) - prisionero

propaganda (propagánda) - propaganda de guerra
resistance (resístans) - resistencia
sergeant (sárdchent) - sargento
soldier (sóuldcher) - soldado

surveillance (sorvéilans) - vigilancia
tank (tank) - tanque
target (tárguet) - blanco, objetivo
territory (térritori) - territorio

play
terrorist (térrorist) - terrorista
to attack (aták) - atacar
to bomb (bóom) - bombardear
to defeat (difíit) - derrotar

to defend (difénd) - defender
to invade (invéid) - invadir
to kill (kil) - matar
to shoot (shúut) - disparar

to wound (wúnd) - herir
trench (trench) - trinchera
troops (trúups) - tropas
war (uór) - guerra

weapons (wépons) - armas