ballot (bálot) - votación
bill (bil) - proyecto de ley
budget (bádchet) - presupuesto
bureaucracy (biurókrasi) - burocracia

cabinet (kábinet) - gabinete
campaign (kampéin) - campaña
candidate (kándideit) - candidato
capitalist (kápitalist) - capitalista

centrist (séntrist) - del centro
citizen (sítissen) - ciudadano
civil servant (cívil sérvant) - empleado público
coalition (koualíshon) - coalición

colonialist (kolóunialist) - colonialista
communist (kómiunist) - comunista
congress (kóngres) - congreso
congressman (kóngresman) - congresista

play
Conservative Party (konsérvativ párti) - partido conservador
democracy (demókrasi) - democracia
democrat (démokrat) - demócrata
democratic (demokrátik) - democrático

Democratic Party (démokratik párti) - partido demócrata
dictator (diktéitor) - dictador
electoral roll (eléktoral róul) - padrón electoral
electorate (iléktorit) - electorado

fascist (fáshist) - fascista
government (gáverment) - gobierno
ideology (aidiólidchi) - ideología
imperialist (impírialist) - imperialista

Labour Party (léibor párti) - partido laborista
law (ló) - ley
left-wing (léft-uíng) - de izquierda
legislature (ledchisléicher) - legislatura

 ¡Juega gratis ahora! WordGrouper
play
liberal (líberal) - liberal
minister (mínister) - ministro
ministry (mínistri) - ministerio
monarchy (mónarki) - monarquía

nationalist (náshonalist) - nacionalista
opposition (oposíshon) - oposición
parliament (párlament) - parlamento
party (párti) - partido

policy (pólisi) - política, plan de acción
political (polítikal) - político (adjetivo)
politician (pólitíshan) - político (persona)
politics (pólitiks) - política

poll (póul) - encuesta, votación
president (président) - presidente
referendum (referéndom) - referendum
republic (ripáblik) - república

play
republican (ripáblikan) - republicano
Republican Party (ripáblikan párti) - partido republicano
right-wing (ráit wíng) - de derecha
rights (ráits) - derechos

senate (sénit) - senado
senator (sénator) - senador
social pressure (sóushal présher) - presión social
socialist (sóushalist) - socialista

suffrage (sáfridch) - sufragio
supreme court (supríim kórt) - corte suprema
taxes (tákses) - impuestos
to elect (elékt) - elegir

to govern (gávern) - gobernar
to run for president (rán for président) - ser candidato a presidente
to vote (vóut) - votar
voter (vóuter) - votante