altar (ólter) - altar
apostle (apósl) - apóstol
archbishop (árch bíshop) - arzobispo
atheism (éiziísm) - ateísmo

baptism (báptism) - bautismo
bible (báibl) - biblia
bishop (bíshop) - obispo
cardinal (cárdinal) - cardenal

cathedral (cazídral) - catedral
cemetery (sémeteri) - cementerio
chapel (chápl) - capilla
chaplain (cháplin) - capellán

charity (chériti) - caridad
choir (kuáir) - coro
church (chérch) - iglesia
clergy (klérdchi) - clero

play
confession (conféshon) - confesión
convent (cónvent) - convento
cult (kolt) - culto
deacon (díkon) - diácono

demon (dímon) - demonio
disciple (disáipl) - discípulo
faith (féiz) - fe
God (god) - Dios

gospel (góspel) - evangelio
heaven (héven) - cielo
hell (hél) - infierno
mass (mas) - misa

miracle (mírakl) - milagro
monastery (mónasteri) - monasterio
monk (monk) - monje
mosque (mósk) - mezquita

 ¡Juega gratis ahora! WordGrouper
play
nun (nán) - monja
parable (párabl) - parábola
paradise (páradais) - paraíso
pastor (pástor) - pastor

pilgrim (pílgrim) - peregrino
pope (póup) - papa
prayer (préer) - oración
priest (príst) - cura

procession (proséshon) - procesión
prophet (prófit) - profeta
psalm (sám) - salmo
purgatory (pérgatori) - purgatorio

rabbi (rábai) - rabino
sacrilege (sákrilidch) - sacrilegio
saint (séint) - santo
sermon (sérmon) - sermón

play
shrine (shráin) - santuario
sin (sin) - pecado
sinner (síner) - pecador
soul (sóul) - alma

synagogue (sínagóg) - sinagoga
temple (témpl) - templo
temptation (temptéishon) - tentación
the devil (de dévl) - el diablo

The Holy Spirit (de jóli spírit) - El Espíritu Santo
vicar (víkar) - vicario
worship (wérship) - adoración