algebra (áldchibra) - álgebra
backpack (bákpak) - mochila
binder (báinder) - carpeta
biology (baiólodchi) - biología

boarding school (bórding skúul) - internado
book (búk) - libro
break (bréik) - recreo
cafeteria (kafetíiria) - cafetería

calculator (kálkiuleitor) - calculadora
calendar (kálender) - calendario
chalk (chók) - tiza
chalkboard (chókbord) - pizarrón

chemistry (kémistri) - química
choir (kuáier) - coro
class (klás) - clase
classmate (klásméit) - compañero de clase

play
classroom (klásrum) - aula
computer science (kompiúrer sáiens) - computación
counselor (kaúnselor) - consejero
course (kóors) - curso

crayon (kréion) - crayón
degree (digríi) - título, licenciatura
desk (desk) - escritorio
diploma (diplóuma) - diploma

dorm (dóorm) - residencia para estudiantes
elementary school (eliméntari skúl) - escuela primaria
encyclopedia (ensaikloupíidia) - enciclopedia
eraser (iréiser) - borrador

exam (egsám) - examen
faculty (fákulti) - profesorado
geometry (dchiómetri) - geometría
globe (glóub) - globo terráqueo

 ¡Juega gratis ahora! WordGrouper
play
grade (gréid) - calificación
gym (dchim) - gimnasio
gym teacher (dchím tíicher) - profesor de gimnasia
high school (hái skul) - escuela secundaria

history (hístori) - historia
hole punch (hóul panch) - perforadora
homework (hóumwork) - tarea
kindergarten (kíndergarten) - jardín de infantes

lab (lab) - laboratorio
library (láibrari) - biblioteca
locker (lóker) - armario
map (map) - mapa

marker (márker) - marcador
math (maz) - matemáticas
notebook (nóutbuk) - cuaderno
pen (pen) - bolígrafo

play
pencil (pénsl) - lápiz
pencil sharpener (pénsl shárpener) - sacapuntas
playground (pléigráund) - patio
poster (póuster) - cartel

principal (prínsipal) - director de escuela
private classes (práivet klásis) - clases particulares
professor (profésor) - profesor
quiz (kuíss) - prueba, test

ruler (rúler) - regla
scholarship (skólarship) - beca
science (sáiens) - ciencia
scissors (síisors) - tijeras

semester (seméster) - semestre
stapler (stéipler) - grapadora
student (stiúdent) - alumno
subject (sábdchékt) - materia, asignatura

play
tape (téip) - cinta adhesiva
teacher (tíicher) - maestro, profesor
test (test) - examen, prueba
vacation (vekéishon) - vacaciones

