aquamarine (ákua-marín) - aguamarina
black (blák) - negro
blue (blúu) - azul
brown (bráun) - marrón

checked (chékt) - a cuadros
chestnut (chéstnat) - castaño
coral (kóral) - coral
crimson (krímson) - púrpura

dark (dárk) - oscuro
dark green (dáark gríin) - verde oscuro
dotted (dótid) - a lunares
dull (dál) - apagado

flowered (fláuerd) - floreado
fuchsia (fáksha) - fucsia
golden (góulden) - dorado
gray (gréi) - gris

play
green (gríin) - verde
indigo (índigou) - índigo
lavender (lávender) - lavanda
light (láit) - claro

loud (láud) - chillón
maroon (marúun) - bordó
mauve (móuv) - lila
navy blue (néivi blúu) - azul marino

ochre (óuker) - ocre
olive (óliv) - oliva
opaque (oupéik) - opaco
orange (órendch) - anaranjado

pale (péil) - pálido
peach (píich) - durazno
pink (pínk) - rosado
plain (pléin) - liso

 ¡Juega gratis ahora! WordGrouper
play
printed (prínted) - estampado
purple (péerpl) - morado
red (red) - rojo
scarlet (skárlet) - rojo escarlata

shiny (sháini) - brillante
silver (sílver) - plata
sky blue (skái blúu) - celeste
striped (stráipt) - a rayas

teal (tíial) - verde azulado
transparent (transpérent) - transparente
turquoise (térkuois) - turquesa
violet (váiolet) - violeta

white (wáit) - blanco
yellow (iélou) - amarillo