alcohol (álkohol) - alcohol
analgesic (analdchísik) - analgésico
antacid tablets (antácid táblets) - pastillas antiácidas
anti-inflammatory (anti-inflámatori) - antiinflamatorio

anti-itch cream (anti-itch krím) - crema contra la picazón
antibiotic (anti-baiótik) - antibiótico
antiseptic (anti-séptik) - antiséptico
Band-Aid (bánd-éid) - Curita

bandage (bándidch) - venda
barbiturate (barbítiurit) - barbitúrico
bottle of aspirin (bótl ov áspirin) - frasco de aspirinas
calcium (kálsiom) - calsio

cold tablets (kóuld táblets) - comprimidos para el resfrío
compound (kómpaund) - compuesto
cotton wool (kóton úul) - algodón
cough drops (kóf drops) - comprimidos para la tos

play
disinfectant (disinféktant) - desinfectante
dose (dóus) - dósis
drugstore (drágstor) - farmacia
eye drops (ái drops) - gotas para los ojos

first-aid box (férst-éid boks) - caja de primeros auxilios
gauze (góos) - gasa
hormone (hórmoun) - hormona
injection (indchékshon) - inyección

insulin (ínsiulin) - insulina
iodine (áiodain) - yodo
lab (lab) - laboratorio
laxative (láxativ) - laxante

medicine (médisin) - medicamento
needle (níidl) - aguja
ointment (óintment) - pomada
painkiller (péin kiler) - calmante para el dolor

 ¡Juega gratis ahora! WordGrouper
play
peroxide (péroksáid) - agua oxigenada
prescription (priskrípshn) - receta
remedy (rémedi) - remedio
sedative (sédativ) - sedante, calmante

skin cream (skín krím) - crema para la piel
sleeping pills (slíipin pils) - pastillas para dormir
sunburn cream (sánbern kríim) - crema para quemaduras de sol
suppository (supositóri) - supositorio

syringe (sríndsh) - jeringa
syrup (sírop) - jarabe
thermometer (zermomíter) - termómetro
throat spray (zróut spréi) - spray para la garganta

tissues (tíshus) - pañuelos de papel
toothbrush (túzbrash) - cepillo de dientes
tube of ointment (tiúb ov-óintment) - tubo de pomada
vitamin C (váitamin sí) - vitamina C