afternoon (áfternúun) - la tarde
April (éipril) - abril
August (óguest) - agosto
century (séntchuri) - siglo

day (déi) - día
decade (dékeid) - década
December (dicémber) - diciembre
early morning (érli mórning) - madrugada

era (íra) - era, época
eternity (itérniti) - eternidad
evening (ívning) - noche
fall / autumn (fól / ótom) - otoño

February (frébruari) - febrero
Friday (fráidei) - viernes
hour (áur) - hora
January (dchéniuari) - enero

 ¡Juega gratis ahora! WordGrouper
play
July (dchulái) - julio
June (dchiún) - junio
March (márch) - marzo
May (méi) - mayo

midnight (mídnait) - medianoche
millennium (miléniom) - milenio
minute (mínit) - minuto
Monday (mándei) - lunes

month (mánz) - mes
morning (mórning) - mañana
night (náit) - noche
noon (núun) - mediodía

November (nouvémber) - noviembre
October (octóuber) - octubre
Saturday (sáterdei) - sábado
second (sékond) - segundo

play
September (septémber) - septiembre
summer (sámer) - verano
Sunday (sándei) - domingo
sunrise (sánrais) - amanecer

sunset (sánset) - atardecer
Thursday (zérsdei) - jueves
Tuesday (tiúsdei) - martes
Wednesday (uénsdei) - miércoles

week (uíik) - semana
winter (uínter) - invierno
year (íar) - año