at dawn (at dóon) - al amanecer
at dusk (at dásk) - al atardecer
at midnight (at mídnait) - a medianoche
at night (at náit) - de noche

at noon (at núun) - al mediodía
every week (évri uíik) - todas las semanas
in a week (in a uíik) - dentro de una semana
in the afternoon (in di áfternúun) - por la tarde

in the early morning (in di érli mórning) - por la madrugada
in the evening (in di ívning) - por la noche
in the morning (in de mórning) - por la mañana
last Friday (lást fráidei) - el viernes pasado

last month (last mánz) - el mes pasado
last night (lást náit) - anoche
last week (last uíik) - la semana pasada
last year (last íar) - el año pasado

play
next Friday (next fráidei) - el viernes que viene
next week (next uíik) - la semana que viene
next year (néxt iár) - el año que viene
the day after (de déi áfter) - el día siguiente

the day after tomorrow (de déi áfter tchumórou) - pasado mañana
the day before (de déi bifór) - el día antes
the day before yesterday (de déi bifór iésterdéi) - anteayer
this evening (dis ívning) - esta noche

this Friday (dis fráidei) - este viernes
this month (dis month) - este mes
this week (dis uíik) - esta semana
this year (dis íar) - este año

three weeks ago (zríi uíiks agóu) - hace tres semanas
today (tchudéi) - hoy
tomorrow (tchumórou) - mañana
tomorrow afternoon (tchumórou afternúun) - mañana por la tarde

play
tomorrow evening (tchumórou ívning) - mañana por la noche
tomorrow morning (tchumórou mórning) - mañana por la mañana
tonight (tchunáit) - esta noche
two days ago (tchú déis agóu) - hace dos días

two days earlier (tchu déis érlier) - dos días antes
two days later (tchu déis léiter) - dos días después
yesterday (iésterdéi) - ayer
yesterday evening (iésterdéi ívning) - ayer por la noche

yesterday morning (iésterdéi mórning) - ayer por la mañana