air hostess (éer jóustes) - azafata
airline (éerláin) - compañía aérea
airport (éerport) - aeropuerto
aisle (áil) - pasillo

arrivals (arráivals) - llegadas
baggage (báguedch) - equipaje
baggage claim (báguedch kléim) - reclamo de equipaje
boarding pass (bóording pas) - tarjeta de embarque

carry-on luggage (kárri-ón-láguedch) - equipaje de mano
cart (kart) - carrito, carretilla
check-in (chék-in) - registración
cockpit (kókpit) - cabina

connecting flight (konékting fláit) - conexión
control tower (kontróul táuer) - torre de control
crew (krú) - tripulación
customs (kástoms) - aduana

play
delayed (diléid) - demorado
departure lounge (dipárcher láundsh) - sala de espera
departures (dipárchers) - salidas
destination (destinéishon) - destino

domestic flight (doméstik fláit) - vuelo de cabotaje
duty free (diúti fríi) - libre de impuestos
emergency exit (imérdchensi éksit) - salida de emergencia
emergency landing (imérdchensi lánding) - aterrizaje de emergencia

excess baggage (eksés báguedch) - exceso de equipaje
flight attendant (fláit aténdant) - auxiliar de vuelo
flight number (fláit námber) - número de vuelo
gate (guéit) - puerta

immigration (immigréishon) - inmigración
international flight (internáshonal fláit) - vuelo internacional
jet lag (dchét lag) - descompensación por la diferencia horaria
landing (lánding) - aterrizaje

 ¡Juega gratis ahora! WordGrouper
play
life vest (láif vest) - chaleco salvavidas
loudspeakers (láudspíikers) - altoparlantes
luggage (láguedch) - equipaje
luggage compartment (láguedsh compárment) - compartimiento para equipaje

meal tray (míil tréi) - bandeja de comida
non-stop flight (nón sópt fláit) - vuelo directo
on schedule (on skédchul) - en horario
one-way trip (uán uéi trip) - viaje de ida

overweight (óuveruéit) - sobrepeso
passenger (pásendcher) - pasajero
passport (pásport) - pasaporte
pilot (páilot) - piloto

plane (pléin) - avión
restrooms (réstrrums) - sanitarios
round trip ticket (ráund trip tíket) - pasaje de ida y vuelta
row (róu) - fila

play
runway (rán uéi) - pista
scales (skéils) - balanza
seat (síit) - asiento
seat belt (síitbelt) - cinturón de seguridad

security check (sekiúriti chek) - control de seguridad
shuttle (shátl) - autobús transbordador
steward (stiúard) - auxiliar de vuelo
stewardess (stiúardes) - azafata

stopover (stópouver) - escala
takeoff (téikoff) - despegue
timetable (táimteibl) - listado de horarios
to board (bóard) - embarcar

to land (land) - aterrizar
to take off (téik óff) - despegar
travel agency (trável éidchensi) - agencia de viajes
visa (visa) - visa