air conditioning (éar condíshonin) - aire acondicionado
antenna (anténa) - antena
back seat (bak sít) - asiento trasero
battery (báteri) - batería, acumulador

blinker (blínker) - guiño, luz direccional
bodywork (bódiwérk) - carrocería
brake (bréik) - freno
car chassis (car chási) - chasis

carburetor (carbiuréitor) - carburador
clutch (clatch) - embrague
dashboard (dáshbord) - tablero del auto
driving lights (dráivin láits) - luces de posición

engine (éndchin) - motor
exhaust pipe (eksóst páip) - caño de escape
fan (fan) - ventilador
fender (fénder) - parachoques

play
front seat (front sít) - asiento delantero
fuel gauge (fiúel géidch) - indicador de nafta
gas pedal (gás pédal) - acelerador
gas tank (gas tánk) - tanque de nafta

gasoline (gásolin) - combustible
gear lever (guíar léver) - palanca de cambios
glove compartment (gláv compártment) - guantera
handbrake (hándbreik) - freno de mano

headlights (hédlaits) - faros
hood (húud) - capot
horn (hórn) - bocina
hubcap (hábcap) - tapa de la rueda

ignition (igníshon) - arranque
lever (léver) - palanca
mudguard (mádgard) - guardabarros
muffler (máfler) - silenciador

 ¡Juega gratis ahora! WordGrouper
play
odometer (odómiter) - contador de kilómetros
oil gauge (óil géidsh) - indicador de aceite
oil pump (óil pamp) - bomba de aceite
parking lights (párkin láits) - luces de posición

plate (pléit) - chapa, patente
radiator (réidiéitor) - radiador
rear lights (ríar láits) - luz trasera
rearview mirror (ríarviú mírror) - espejo retrovisor

reverse (rivérs) - marcha atrás
seat belt (síit belt) - cinturón de seguridad
shock absorber (shók absórber) - amortiguador
side lights (sáid láits) - luces de posición

side mirror (sáid mírror) - espejo lateral
spare wheel (spéar uíl) - rueda de auxilio
spark plug (spárk plag) - bujía
speedometer (spidomíter) - velocímetro

play
steering wheel (stíirin wíil) - volante
temperature gauge (témpricher géidsh) - indicador de temperatura
tire (táier) - neumático, cubierta
trunk (tránk) - baúl

wheels (wíils) - ruedas
windshield (wínshíld) - parabrisas
windshield wiper (wínshíld wáiper) - limpiaparabrisas