ball bearing (ból béring) - cojinete de bolas
bell (bel) - timbre
brake (bréik) - freno
brake handle (breík hándl) - palanca de freno

cable (kéibl) - cable
carrier (kárrier) - portaequipajes
chain (chéin) - cadena
chain wheel (chéin uíil) - plato

crossbar (crósbar) - barra
cyclist (sáiklist) - ciclista
dynamo (dáinamou) - dínamo
engine (éndchin) - motor

exhaust pipe (eksóst páip) - escape
gearlever (guíerlever) - palanca de velocidades
grips (grips) - puños
handlebar (hándl bar) - manubrio, manillar

 ¡Juega gratis ahora! WordGrouper
play
helmet (hélmit) - casco
horn (hórn) - bocina
hub (hab) - eje
inner tube (íner tiúb) - cámara de aire

kick stand (kík stánd) - pie
lamp (lámp) - faro
lock (lók) - seguro, traba
motorcycle (móutor sáikl) - motocicleta

mudguard (mádgard) - guardabarros
patch (pách) - parche
pedal (pédal) - pedal
pump (pámp) - inflador

puncture (pánkcher) - pinchazo
rear light (ríar láit) - piloto
reflector (rifléktor) - ojo de gato, catafaro
rim (rim) - llanta

play
saddle (sádl) - sillín
scooter (skúter) - motoneta
shock absorbers (shok absórbers) - amortiguadores
spoke (spóuk) - rayo

sprocket (sprókit) - piñón
tire (táier) - neumático
tricycle (tráisikl) - triciclo
valve (válv) - válvula

wheel (uíil) - rueda