aircraft carrier (érkraft kárrier) - portaaviones
barge (bárdch) - barcaza
battle ship (bátl ship) - acorazado
boat (bóut) - buque, navío

canoe (kanú) - canoa
cargo boat (kárgou bóut) - buque de carga
coast guard ship (kóust gárd ship) - guardacostas
cranes (kréins) - grúas

cruise ship (krúus ship) - crucero de placer
cruiser (krúuser) - crucero de la marina
destroyer (distróier) - destructor
dock (dok) - dársena

ferry (férri) - transbordador
fishing boat (físhing bóut) - barco pesquero
freighter (fréiter) - carguero
houseboat (háusbóut) - casa flotante

 ¡Juega gratis ahora! WordGrouper
play
hovercraft (háverkraft) - aerodeslizador
hydroplane (háidro-pléin) - hidroavión
kayak (káiak) - kayac
launch (lónch) - lancha

lifeboat (láifbout) - bote salvavidas
liner (láiner) - transatlántico
merchant ship (mérchant ship) - barco mercante
minerlayer (máiner léier) - minador

minesweeper (máinsuíiper) - dragaminas
motorboat (mótorbóut) - lancha
quay (kíi) - muelle
rowing boat (róuin bóut) - bote a remos

sailing boat (séilin bóut) - barco de vela, velero
ship (ship) - buque, barco
shipyard (shíp-iard) - astillero
skiff (skíf) - esquife

play
steamer (stímer) - barco de vapor
submarine (sabmarín) - submarino
tanker (tánker) - petrolero
torpedo boat (torpídou bóut) - torpedero

training ship (tréinin ship) - barco-escuela
tug boat (tág bóut) - remolcador
vessel (vésl) - nave, barco
warship (wórship) - barco de guerra

whaler (wéiler) - ballenero
wharf (wórf) - embarcadero, muelle
yacht (iót) - yate