anchor (ánkor) - ancla
bow (báu) - proa
bridge (bridch) - puente de mando
buoy (buói) - boya

cabin (kábin) - camarote
captain (kápten) - capitán
chain (chéin) - cadena
compass (kómpas) - brújula

crew (krú) - tripulación
deck (dek) - cubierta
dinghy (díngui) - bote
engine room (éndchin rúum) - sala de máquinas

fire hydrant (fáier háidrant) - boca de incendio
flare (fléar) - bengala
foremast (fórmast) - trinquete
funnel (fánel) - chimenea

 ¡Juega gratis ahora! WordGrouper
play
galley (gáli) - cocina
gangway (gáng-uéi) - pasarela de salida
hatch (hátch) - escotilla
hold (hóuld) - bodega

horn (hórn) - sirena
hose (hóuss) - manguera
hull (hal) - casco
keel (kíil) - quilla

ladder (láder) - escalera
launching (lóonching) - botadura
life belt (láif-belt) - salvavidas
life jacket (láif-dcháket) - chaleco salvavidas

life raft (láif raft) - balsa salvavidas
lifeboat (láif bóut) - bote salvavidas
line (láin) - soga, cable, cabo
mast (mast) - mástil

play
master (máster) - capitán
oars (óors) - remos
pier (píer) - embarcadero
port side (pórt sáid) - babor

porthole (pórthoul) - ojo de buey
propeller (propéler) - hélice
rudder (ráder) - timón
sail (séil) - vela

sailor (séilor) - marinero
starboard (stárbord) - estribor
stern (stern) - popa