ambulance (ámbiulans) - ambulancia
anaesthesia (aneszísia) - anestesia
appointments book (apóintment buk) - Libro de citas
blood pressure (blád présher) - presión sanguínea

blood test (blád test) - prueba de sangre
breathing apparatus (bríiding aparátos) - respirador artificial
capsule (kápsiul) - cápsula
car accident (kar áksident) - accidente de autos

check-up (chekáp) - chequeo médico
doctor (dóktor) - doctor
dressing gown (drésing gáun) - bata
emergency room (imérdchensi rum) - sala de emergencias

examination couch (eksaminéishon káuch) - diván de reconocimiento
first aid (férst éid) - primeros auxilios
gauze (góos) - gasa
health insurance (jélz inshúrans) - seguro médico

 ¡Juega gratis ahora! WordGrouper
play
injection (indchékshon) - inyección
intensive care unit (inténsiv kér iúnit) - unidad de cuidados intensivos
laboratory (láboratori) - laboratorio
mask (mask) - mascarilla

medical record (médikal récord) - historia clínica
medicine cabinet (médisin kábinet) - armario de remedios
microscope (máikroskóup) - microscopio
nurse (néers) - enfermera

operating table (óperéiting téibl) - mesa de operaciones
operation (operéishon) - operación
oxygen (óksidchen) - oxigeno
painkiller (péinkiler) - calmante para el dolor

paramedics (páramediks) - paramédicos
patient (péishent) - paciente
physician (fisíshan) - médico clínico
plaster (pláster) - yeso

play
prescription (preskrípshon) - receta
pyjamas (padchámas) - piyama
sleeping pills (slíiping pils) - pastillas para dormir
slippers (slípers) - pantuflas

stitches (stíchis) - puntos de sutura
stretcher (strécher) - camilla
surgeon (sérdchon) - cirujano
surgical instruments (sérchikal ínstruments) - instrumentos quirúrgicos

syringes (sríndchis) - jeringas
therapy (zérapi) - terapia
treatment (tríitment) - tratamiento
waiting room (uéiting rum) - sala de espera

wheelchair (uíilcher) - silla de ruedas
x-ray plate (eks réi pláte) - radiografía