abdomen (ábdomen) - vientre
ankle (ánkl) - tobillo
appendix (apéndix) - apéndice
arm (áarm) - brazo

armpit (áarmpit) - axila
artery (árteri) - arteria
back (bák) - espalda
beard (bíerd) - barba

belly (béli) - panza
bladder (bláder) - vejiga
blood (bláad) - sangre
bones (bóuns) - huesos

bottom (bótom) - trasero
bowels (báuels) - entrañas
brain (bréin) - cerebro
breasts (brésts) - mamas

play
bust (bást) - busto
buttocks (bátoks) - nalgas
calf (káaf) - pantorrilla
cheekbones (chíikbóuns) - pómulos

cheeks (chíiks) - mejillas
chest (chést) - pecho
chin (chín) - mentón
ears (íars) - orejas

elbow (élbou) - codo
eyebrows (áibráus) - cejas
eyelashes (áiláshis) - pestañas
eyelids (áilids) - párpados

eyes (áis) - ojos
face (féis) - cara, rostro
feet (fíit) - pies
fingers (fínguers) - dedos

 ¡Juega gratis ahora! WordGrouper
play
fist (fist) - puño
flesh (flesh) - carne
foot (fút) - pie
forearm (fóorárm) - antebrazo

forehead (fór hed) - frente
genitals (dchénitals) - genitales
hair (héer) - cabello
hand (hánd) - mano

head (héd) - cabeza
heart (hárt) - corazón
heel (híil) - talón
hips (hips) - caderas

instep (ínstep) - empeine
intestines (intéstins) - intestinos
jaw (dchó) - mandíbula
kidneys (kídnis) - riñones

play
knee (níi) - rodilla
knuckles (nákls) - nudillos
leg (leg) - pierna
limbs (limbs) - extremidades

lips (lips) - labios
liver (líver) - hígado
lungs (lángs) - pulmones
moustache (mostásh) - bigote

mouth (máuz) - boca
muscles (másls) - músculos
nails (néils) - uñas
nape (néip) - nuca

navel (néivl) - ombligo
neck (nék) - cuello
nipples (nípls) - pezones, tetillas
organs (órgans) - órganos

 ¡Juega gratis ahora! WordGrouper
play
palm (páam) - palma
pancreas (pánkrias) - páncreas
pelvis (pélvis) - pélvis
penis (pínis) - pene

rib (rib) - costilla
shin (shín) - espinilla, canilla
shoulder (shóulder) - hombro
sideburns (sáidbérns) - patillas

skeleton (skéleton) - esqueleto
skin (skin) - piel
skull (skál) - cráneo
sole (sóul) - planta

spine (spáin) - columna vertebral
stomach (stómak) - estómago
teeth (tíiz) - dientes
temples (témpls) - sienes

play
thigh (zái) - muslo
thorax (zórax) - tórax
throat (zróut) - garganta
toes (tóus) - dedos (del pie)

tongue (tóng) - lengua
tooth (túuz) - diente
torso (tórsou) - torso
trunk (tránk) - tronco

vagina (vadcháina) - vagina
vein (véin) - vena
waist (uéist) - cintura
wrinkles (rínkls) - arrugas

wrist (ríst) - muñeca