antenna (anténa) - antena
attic (átic) - desván
back yard (bák iárd) - patio trasero
balcony (bálconi) - balcón

basement (béisment) - sótano
bathroom (báz rum) - baño
bedroom (béd rum) - dormitorio
ceiling (síling) - cielorraso

cellar (sélar) - sótano, bodega
chimney (chímni) - chimenea
deck (dék) - balcón terraza
dining room (dáining rúm) - comedor

door (dóor) - puerta
door handle (dóor jándl) - picaporte
doorbell (dóorbel) - timbre
driveway (dráiv uéi) - entrada par el auto

play
fence (féns) - cerca
fence gate (féns guéit) - puerta de la cerca
floor (flóor) - piso
front yard (frónt iárd) - patio frontal

garage (garádch) - garage
garden (gárden) - jardín
garden shed (gárden shed) - cobertizo
ground floor (gráund flóor) - planta baja

hall (hóol) - vestíbulo
hallway (hóol wéi) - pasillo
hedge (hédch) - seto
key (kíi) - llave

kitchen (kíchen) - cocina
laundry room (lóndri rúum) - lavadero
lawn (lóon) - césped
living room (líving rúm) - sala

 ¡Juega gratis ahora! WordGrouper
play
lock (lóok) - cerradura
mailbox (méilboks) - buzón
pantry (pántri) - despensa
patio (pátiou) - patio

peephole (píipjóul) - mirilla de la puerta
pool (pul) - piscina
porch (póorch) - pórtico
roof (rúf) - techo

room (rúum) - habitación
skylight (skái-láit) - tragaluz, claraboya
staircase (stér kéis) - escalera
steps (stéps) - escalones

study (stádi) - despacho, estudio
utility room (iutíliti rúum) - cuarto de servicio
veranda (veránda) - galería, veranda
wall (uól) - pared

window (uíndou) - ventana