basket (básket) - canasto
bath mat (báz mát) - alfombra de baño
bath salts (baz sólts) - sales de baño
bathtub (báz tab) - bañera, tina

bidet (bídei) - bidé
brush (brásh) - cepillo
bubble (bábl) - burbuja
cold water (cóuld uóter) - agua fría

comb (cóum) - peine
curtain (kér-ten) - cortina
deodorant (dióudorant) - desodorante
drain (dréin) - desague

electric razor (iléktrik réisor) - afeitadora eléctrica
faucet (fóset) - canilla, grifo
floss (flóss) - hilo dental
foam (fóum) - espuma

play
hair dryer (héer dráier) - secador de pelo
hair gel (héer dchél) - gomina, gel
hairbrush (héerbrash) - cepillo de pelo
hand towel (hánd tául) - toallita de mano

hot water (hót uóter) - agua caliente
lipstick (lípstik) - lápiz de labios
lotion (lóushon) - loción
medicine chest (médicin chést) - botiquín

nail clippers (néil clípers) - cortaúñas
nail polish (néil pólish) - esmalte de uñas
nailbrush (néilbrash) - cepillo de uñas
perfume (pérfium) - perfume

razor (réissor) - afeitadora, rasuradora
razor blade (réissor bléid) - hoja de afeitar
scale (skéil) - balanza, báscula
shampoo (shampúu) - champú

 ¡Juega gratis ahora! WordGrouper
play
shaving cream (shéiving críim) - crema de afeitar
shelf (shélf) - repisa
shower (sháuer) - ducha
sink (sink) - pileta, lavabo

soap (sóup) - jabón
soap dish (sóup dish) - jabonera
sponge (spándch) - esponja
stopper (stóper) - tapón

tile (táil) - azulejo
toilet (tóilit) - inodoro, retrete
toilet paper (tóilit péiper) - papel higiénico
toothbrush (túzbrash) - cepillo de dientes

toothpaste (túzpeist) - pasta dentífrica
towel (tául) - toalla
towel rack (tául raek) - toallero
tweezers (tuíssers) - pinzas depiladoras

washcloth (uósh cloz) - toallita de ducha